##########                        ########
#       O#                        #      #
#X  X    #                        #PXO   #
#O       #                        ########
####     #
#O       #
#     X  #
# P      #
#        #
##########
