##########
#    #####
#P  X   O#
#    #####
##########