#########################################                  ################ 
P                                      ##                  ##               
###################################### ##                  ## ############# 
                                    ## ##                  ## ##            
                                    ## ##                  ## ##            
                                    ## ##                  ## ##            
                                    ## ##                  ## ##            
                                    ## ##                  ## ##            
                                    ## ##                  ## ##            
                                    ## ##                  ## ##            
                                    ## ##                  ## ##            
                                    ## ##                  ## ##            
                                    ## ###################### ##            
                                    ##                        ##            
                                    ############################            