##########
#       O#
#X  X    #
#O       #
####     #
#O       #
#     X  #
# P      #
#        #
##########
